[40][20]
|0|0|0|0|0|0|0|0|0|0|0|0|0|0|0|0|0|0|0|0|0|0|0|0|0|0|0|0|0|0|0|0|0|0|0|0|0|0|0|0|
|0|0|0|0|0|0|0|0|0|0|0|0|0|0|0|0|0|0|0|0|0|0|0|0|0|0|0|0|0|0|0|0|0|0|0|0|0|0|0|0|
|0|0|0|0|0|0|0|0|0|2|2|2|2|2|0|0|0|0|0|0|0|0|0|0|0|0|0|0|0|0|0|0|0|0|0|0|0|0|0|0|
|7|0|0|0|0|0|0|0|0|2|0|0|0|2|0|0|0|0|0|0|0|0|0|0|0|0|0|0|0|0|0|0|0|0|0|0|0|0|0|0|
|7|0|0|0|0|0|0|0|0|2|0|0|0|2|0|0|0|0|0|0|0|0|0|0|0|0|0|0|0|0|0|0|0|0|0|0|0|0|0|0|
|2|2|0|0|0|4|2|2|2|2|0|0|0|2|2|2|2|2|2|5|0|0|0|0|0|0|0|0|0|0|0|0|0|0|0|0|0|0|0|0|
|0|0|0|0|4|2|0|0|0|0|0|0|0|0|0|0|0|0|0|2|5|0|0|0|0|0|0|0|0|0|0|0|0|0|0|0|0|0|0|0|
|0|0|0|3|2|0|0|0|0|0|0|0|0|0|0|0|0|0|0|0|2|5|0|0|0|0|0|0|0|0|0|0|0|0|0|0|0|0|0|0|
|0|0|4|3|0|0|0|0|0|0|0|0|0|0|0|0|0|0|0|0|0|2|6|0|0|0|0|0|0|0|0|0|0|0|0|0|0|0|0|0|
|0|4|2|3|0|0|0|0|0|0|0|0|0|0|0|0|0|0|0|0|0|0|6|5|0|0|0|0|0|0|0|0|0|0|0|0|0|0|0|0|
|4|2|0|3|0|0|0|0|0|0|0|0|0|0|0|0|0|0|0|0|0|0|0|2|5|0|0|0|0|0|0|0|0|0|0|0|0|0|0|0|
|2|0|0|3|0|0|0|0|0|0|0|0|0|0|0|0|0|0|0|0|0|0|0|0|2|2|0|0|0|0|0|0|0|0|0|0|0|0|0|0|
|2|0|0|3|0|0|0|0|0|0|0|0|0|0|0|0|0|0|0|0|0|0|0|0|2|0|2|0|0|0|0|0|0|0|0|0|0|0|0|0|
|2|0|0|3|0|0|0|0|0|0|0|0|0|0|0|0|0|0|0|0|0|0|0|0|2|0|0|2|0|0|0|0|0|0|0|0|0|0|0|0|
|2|0|0|3|0|0|0|0|0|0|0|0|0|0|0|0|0|0|0|0|0|0|0|0|2|0|0|0|2|0|0|0|0|0|0|0|0|0|0|0|
|2|0|0|3|0|0|0|0|0|0|0|0|0|0|0|0|0|0|0|0|0|0|0|0|2|0|0|0|0|2|0|0|0|0|0|0|0|0|0|0|
|2|0|0|3|0|0|0|0|0|0|0|0|0|0|0|0|0|0|0|0|0|0|0|8|2|0|0|0|0|0|2|0|0|0|0|0|0|0|0|8|
|2|0|0|3|0|0|0|0|0|0|0|0|0|0|0|0|0|0|0|0|0|0|0|8|2|0|0|0|0|0|0|2|0|0|0|0|0|0|0|8|
|2|9|9|3|9|9|9|9|9|9|9|9|9|9|9|9|9|9|9|9|9|9|9|9|2|10|10|10|10|10|10|10|10|10|10|10|10|10|10|10|
|1|1|1|1|1|1|1|1|1|1|1|1|1|1|1|1|1|1|1|1|1|1|1|1|1|1|1|1|1|1|1|1|1|1|1|1|1|1|1|1|
