[40][25]
|7|7|7|7|7|7|7|7|7|7|7|7|7|7|7|7|7|7|7|7|7|7|7|7|7|7|7|7|7|7|7|7|7|7|7|7|7|7|7|7|
|7|0|0|0|0|0|0|0|0|0|0|0|0|0|0|0|0|0|0|8|8|0|0|0|0|0|0|0|0|0|0|0|0|0|0|0|0|0|0|7|
|7|0|0|0|0|0|0|0|0|0|0|0|0|0|0|0|0|8|8|8|8|8|8|0|0|0|0|0|0|0|0|0|0|0|0|0|0|0|0|7|
|7|0|0|0|0|0|0|0|0|0|0|0|0|0|0|8|8|8|0|0|0|0|8|8|8|0|0|0|0|0|0|0|0|0|0|0|0|0|0|7|
|7|0|0|0|0|0|0|0|0|0|0|0|0|8|8|8|0|0|0|0|0|0|0|0|8|8|8|0|0|0|0|0|0|0|0|0|0|0|0|7|
|7|0|0|0|0|0|0|0|0|0|0|8|8|8|0|0|0|0|0|0|0|0|0|0|0|0|8|8|8|0|0|0|0|0|0|0|0|0|0|7|
|7|0|0|0|0|0|0|0|0|8|8|8|0|0|0|0|0|0|0|0|0|0|0|0|0|0|0|0|8|8|8|0|0|0|0|0|0|0|0|7|
|7|0|0|0|0|0|0|8|8|8|0|0|0|0|0|0|0|0|0|0|0|0|0|0|0|0|0|0|0|0|8|8|8|0|0|0|0|0|0|7|
|7|0|0|0|0|8|8|8|0|0|0|0|0|0|0|0|0|0|0|0|0|0|0|0|0|0|0|0|0|0|0|0|8|8|8|0|0|0|0|7|
|7|0|0|8|8|8|0|0|0|0|0|0|0|6|0|0|0|0|0|0|0|0|6|0|0|0|0|0|0|0|0|0|0|0|8|8|8|0|0|7|
|7|8|8|8|0|0|0|0|0|0|0|0|0|0|0|0|0|0|0|0|0|0|0|0|0|0|0|0|0|0|0|0|0|0|0|0|8|8|8|7|
|7|1|0|0|0|0|0|0|0|0|0|0|0|0|0|0|0|0|0|0|0|0|0|0|0|0|0|0|0|0|0|0|0|0|0|0|0|0|1|7|
|7|1|0|0|0|0|0|0|0|0|0|0|0|0|0|0|0|0|0|0|0|0|0|0|0|6|0|0|0|0|0|0|0|0|0|0|0|0|1|7|
|7|1|0|0|0|0|0|0|0|0|0|0|6|0|0|0|0|0|0|0|0|0|0|0|6|6|0|0|0|0|0|0|0|0|0|0|0|0|1|7|
|7|1|0|0|0|0|0|0|0|0|0|0|6|0|0|0|0|0|0|0|0|0|0|0|6|0|0|0|0|0|0|0|0|0|0|0|0|0|1|7|
|7|1|0|0|0|0|0|0|0|0|0|0|6|6|0|0|0|0|0|0|0|0|0|6|0|0|0|0|0|0|0|0|0|0|0|0|0|0|1|7|
|7|1|0|0|0|0|0|0|0|0|0|0|0|0|6|6|0|0|0|0|0|0|6|6|0|0|0|0|0|0|0|0|0|0|0|0|0|0|1|7|
|7|1|0|0|0|0|0|0|0|0|0|0|0|0|0|0|6|6|0|0|0|0|6|0|0|0|0|0|0|0|0|0|0|0|0|0|0|0|1|7|
|7|1|0|0|0|0|0|0|0|0|0|0|0|0|0|0|0|6|6|6|6|6|6|0|0|0|0|0|0|0|0|0|0|0|0|0|0|0|1|7|
|7|1|0|0|0|0|0|0|0|0|0|0|0|0|0|0|0|0|0|0|0|0|0|0|0|0|0|0|0|0|0|0|0|0|0|0|0|0|1|7|
|7|1|0|0|0|0|0|0|0|0|0|0|0|0|0|0|0|0|0|0|0|0|0|0|0|0|0|0|0|0|0|0|0|0|0|0|0|0|1|7|
|7|1|0|0|0|0|0|0|0|0|0|0|0|0|0|0|0|0|0|0|0|0|0|0|0|0|0|0|0|0|0|0|0|0|0|0|0|0|1|7|
|7|1|0|0|0|0|0|0|0|0|0|0|0|0|0|0|0|0|0|0|0|0|0|0|0|0|0|0|0|0|0|0|0|0|0|0|0|0|1|7|
|7|1|0|0|0|0|0|0|0|0|0|0|0|0|0|0|0|0|0|0|0|0|0|0|0|0|0|0|0|0|0|0|0|0|0|0|0|0|1|7|
|7|7|7|7|7|7|7|7|7|7|7|7|7|7|7|7|7|7|7|7|7|7|7|7|7|7|7|7|7|7|7|7|7|7|7|7|7|7|7|7|
