[40][20]
|1|1|1|1|1|1|1|1|1|1|1|1|1|1|1|1|1|1|1|1|1|1|1|1|1|1|1|1|1|1|1|1|1|1|1|1|1|1|1|1|
|1|19|0|0|0|0|0|0|0|0|0|0|0|0|0|0|0|0|0|0|0|0|0|0|0|0|0|0|0|0|0|0|0|0|0|0|0|0|0|1|
|1|9|9|9|9|9|9|9|9|9|9|9|9|9|9|9|9|9|9|9|9|9|9|9|9|9|9|9|9|9|9|9|9|9|9|9|9|9|0|1|
|1|2|2|2|2|2|2|2|2|2|2|2|2|2|2|2|2|2|2|2|2|2|2|2|2|2|2|2|2|2|2|2|2|2|2|2|2|2|0|1|
|1|0|0|0|0|6|2|2|2|2|2|2|2|2|2|0|0|0|0|0|0|0|6|2|2|2|2|2|2|2|2|2|7|0|0|0|0|0|0|1|
|1|0|9|0|0|0|6|2|2|2|2|2|2|2|2|0|9|9|801|0|0|0|0|6|2|2|2|2|2|2|2|7|0|0|0|0|9|9|9|1|
|1|3|2|0|0|0|0|6|2|2|2|2|2|2|2|3|2|2|2|0|0|0|0|0|6|2|2|2|2|2|7|0|0|0|0|0|2|2|2|1|
|1|3|2|2|0|0|0|0|6|2|2|2|2|2|2|3|2|2|2|2|0|0|0|0|0|6|2|2|2|7|0|0|0|0|0|2|2|2|2|1|
|1|3|2|2|2|0|0|0|0|6|2|2|2|2|2|3|2|2|2|2|2|0|0|0|0|0|6|2|7|0|0|0|0|0|2|2|2|2|2|1|
|1|3|2|2|2|2|0|0|0|0|6|2|2|2|2|3|2|2|2|2|2|2|0|0|0|0|0|8|0|0|0|0|0|2|2|2|2|2|2|1|
|1|3|2|2|2|2|2|0|0|0|0|6|2|2|2|3|2|2|2|2|2|2|2|0|0|0|0|0|0|0|0|0|2|2|2|2|2|2|2|1|
|1|3|2|2|2|2|2|2|0|0|0|0|6|2|2|3|2|2|2|2|2|2|2|2|28|0|0|0|0|0|26|2|2|2|2|2|2|2|2|1|
|1|3|2|2|2|2|2|2|2|0|0|0|0|0|0|3|2|2|2|2|2|2|2|7|0|0|0|0|0|0|0|6|2|2|2|2|2|2|2|1|
|1|3|2|2|2|2|2|2|2|2|0|0|0|0|0|3|2|2|2|2|2|2|7|0|0|0|0|9|0|0|0|0|6|2|2|2|2|2|2|1|
|1|3|2|2|2|2|2|2|2|2|2|9|9|9|9|3|2|2|2|2|2|7|0|0|0|0|0|2|0|0|0|0|0|6|2|2|2|2|2|1|
|1|3|2|2|2|2|2|2|2|2|2|2|2|2|2|2|2|2|2|2|7|0|0|0|0|0|2|2|2|0|0|0|0|0|6|2|2|2|2|1|
|1|3|2|2|2|2|2|2|2|2|2|2|2|2|2|2|2|2|2|7|0|0|0|0|0|2|2|2|2|2|0|0|0|0|0|6|2|2|2|1|
|1|3|0|0|0|0|0|0|0|0|0|0|0|0|0|0|0|0|0|0|0|0|0|0|2|2|2|2|2|2|2|0|0|0|0|0|0|0|901|1|
|1|3|9|9|9|9|9|9|9|9|9|9|9|9|9|9|9|9|9|9|9|9|9|2|2|2|2|2|2|2|2|2|9|9|9|9|9|9|0|1|
|1|1|1|1|1|1|1|1|1|1|1|1|1|1|1|1|1|1|1|1|1|1|1|1|1|1|1|1|1|1|1|1|1|1|1|1|1|1|1|1|
