[40][20]
|1|1|1|1|1|1|1|1|1|1|1|1|1|1|1|1|1|1|1|1|1|1|1|1|1|1|1|1|1|1|1|1|1|1|1|1|1|1|1|1|
|1|0|552|2|19|0|0|0|0|0|0|0|0|0|0|0|0|0|0|0|0|0|0|0|0|0|0|0|0|0|0|0|0|0|0|0|0|0|0|1|
|1|0|0|2|0|0|0|0|0|0|0|0|0|0|0|0|0|0|0|0|0|0|0|0|0|0|0|0|0|0|0|0|0|0|0|801|0|0|0|1|
|1|3|2|2|2|2|2|2|2|2|2|2|0|0|0|0|0|0|0|0|0|0|0|0|0|0|0|0|0|0|0|0|0|0|0|6|2|2|3|1|
|1|3|2|7|0|0|0|0|0|0|0|6|2|2|2|2|2|2|2|2|2|2|3|0|0|0|0|0|0|0|0|0|0|0|0|0|6|2|3|1|
|1|3|7|0|0|0|0|0|0|0|806|0|0|0|0|0|0|0|0|0|0|2|3|0|0|0|0|0|0|0|0|0|0|0|0|0|0|6|3|1|
|1|3|0|0|3|2|2|2|2|2|2|0|0|0|0|0|0|0|0|0|0|2|3|3|3|6|2|2|2|2|2|2|7|0|2|0|0|0|3|1|
|1|3|0|0|3|0|0|0|0|0|6|2|0|0|0|0|0|0|0|4|2|2|2|5|3|0|0|0|0|0|0|0|0|0|2|0|0|0|3|1|
|1|3|0|0|3|0|0|0|0|0|0|6|0|0|0|0|0|0|0|2|7|8|6|2|3|0|0|0|0|0|0|0|0|0|2|0|0|0|3|1|
|1|3|0|2|2|2|2|2|0|0|0|0|0|0|2|2|2|2|2|2|0|0|0|2|2|2|2|2|2|2|2|2|2|2|2|0|0|0|3|1|
|1|3|2|2|7|8|6|2|2|0|0|0|0|0|0|0|0|0|26|2|0|0|0|2|28|0|0|0|0|0|0|0|0|0|0|0|0|0|3|1|
|1|3|0|2|0|0|0|2|6|2|0|0|0|0|0|0|0|0|0|2|0|0|0|2|0|0|0|0|0|0|0|0|0|0|0|0|0|0|3|1|
|1|3|0|6|0|0|0|7|0|6|2|0|0|0|0|0|0|0|0|0|0|0|0|0|0|0|0|0|2|2|0|0|0|0|0|0|0|0|3|1|
|1|3|0|0|0|0|0|0|0|0|6|2|0|0|0|0|0|0|0|0|0|0|0|0|0|0|0|2|2|2|2|0|0|3|0|0|0|0|3|1|
|1|3|2|0|0|0|0|0|0|0|0|0|0|0|0|3|2|2|2|2|2|0|2|2|2|2|2|2|2|2|2|2|2|3|0|0|0|2|3|1|
|1|3|2|2|0|0|0|0|0|0|0|0|0|0|0|3|2|0|27|0|0|0|2|0|27|0|2|0|0|0|0|2|0|3|0|0|2|2|3|1|
|1|3|2|2|2|0|0|0|0|0|3|2|2|2|2|2|0|0|0|0|0|0|0|0|0|0|2|0|0|0|0|2|0|3|0|2|2|2|3|1|
|1|3|0|701|0|0|0|0|0|0|3|0|0|0|0|0|0|0|0|0|0|0|0|0|0|0|706|0|0|0|902|2|0|3|0|0|0|0|3|1|
|1|3|0|0|0|0|0|0|0|0|3|0|0|0|0|0|0|0|0|0|0|0|0|0|0|0|0|0|0|0|0|2|0|3|0|0|0|0|3|1|
|1|1|1|1|1|1|1|1|1|1|1|1|1|1|1|1|1|1|1|1|1|1|1|1|1|1|1|1|1|1|1|1|1|1|1|1|1|1|1|1|
