[40][20]
|1|1|27|27|27|27|27|27|27|27|27|27|27|27|27|27|27|27|27|27|27|27|27|27|27|27|27|27|27|27|27|27|27|27|27|27|27|27|1|1|
|0|0|0|0|0|0|0|0|0|0|0|0|0|0|0|0|0|0|0|0|0|0|0|0|0|0|0|0|0|0|0|0|0|0|0|0|0|0|0|0|
|0|0|0|0|0|0|0|0|0|0|0|0|0|0|0|0|0|0|0|0|0|0|0|0|0|0|0|0|0|0|0|0|0|0|0|0|0|0|0|0|
|0|0|0|0|0|0|0|0|0|0|0|0|0|0|0|0|0|0|0|0|0|0|0|0|0|0|0|0|0|0|0|0|0|0|0|0|0|0|0|0|
|0|0|0|0|0|0|0|0|0|0|0|0|0|0|0|0|0|0|0|0|0|0|0|0|0|0|0|0|0|0|0|0|0|0|0|0|0|0|0|0|
|0|0|0|0|0|0|0|0|0|0|0|0|0|0|0|0|0|0|0|0|0|0|0|0|0|0|0|27|27|0|0|0|0|0|0|0|0|0|0|0|
|0|0|0|0|0|0|0|0|0|0|0|0|27|27|0|0|0|0|0|0|0|0|0|0|0|0|0|0|0|0|0|0|0|0|0|0|0|0|0|0|
|0|0|0|0|0|0|0|0|0|0|0|0|0|0|0|0|0|0|1|1|27|27|0|0|0|0|0|0|0|0|0|0|0|0|0|0|0|0|0|0|
|0|0|0|0|1|1|1|1|0|0|0|0|0|0|0|0|0|0|0|0|0|0|0|0|0|0|0|0|0|0|0|0|0|0|27|27|0|0|0|0|
|0|0|0|0|0|0|0|0|0|0|0|0|0|0|0|0|0|0|0|0|0|0|0|0|0|0|0|0|0|0|0|0|0|0|0|0|0|0|0|0|
|0|0|0|0|0|0|0|0|0|0|0|0|0|0|0|0|0|0|0|0|0|0|0|0|0|0|0|0|0|0|0|0|0|0|0|0|0|0|0|0|
|0|0|0|0|0|0|0|0|0|0|0|0|0|0|0|0|0|0|0|0|0|0|0|0|0|0|0|0|0|0|0|0|0|0|0|0|0|0|0|0|
|0|0|0|0|0|0|0|0|0|0|0|0|0|0|1|3|0|0|0|0|0|0|0|0|0|0|0|0|0|0|0|0|0|0|0|0|0|0|0|0|
|0|0|0|0|0|0|0|0|0|0|0|0|0|0|1|3|0|0|0|0|0|0|0|0|0|0|0|0|0|0|0|0|0|0|0|0|0|0|0|0|
|900|0|0|0|0|0|0|0|0|0|0|0|0|550|1|3|0|0|0|0|0|0|0|0|0|0|0|0|0|0|0|0|0|0|0|0|0|0|0|19|
|0|0|0|0|0|0|0|0|0|0|0|0|0|0|1|3|0|0|0|0|0|0|0|0|0|0|0|0|0|0|0|0|0|0|0|0|0|0|0|0|
|1|1|1|1|1|1|1|1|1|1|1|1|1|1|1|1|1|1|1|1|1|1|1|1|1|1|1|1|1|1|1|1|1|1|1|1|1|1|1|1|
|1|1|2|2|1|1|2|2|1|1|2|2|1|1|2|2|1|1|2|2|1|1|2|2|1|1|2|2|1|1|2|2|1|1|2|2|1|1|2|2|
|1|2|2|1|1|2|2|1|1|2|2|1|1|2|2|1|1|2|2|1|1|2|2|1|1|2|2|1|1|2|2|1|1|2|2|1|1|2|2|1|
|2|2|1|1|2|2|1|1|2|2|1|1|2|2|1|1|2|2|1|1|2|2|1|1|2|2|1|1|2|2|1|1|2|2|1|1|2|2|1|1|
