[40][20]
|1|0|0|0|0|0|0|0|0|0|0|0|0|0|0|0|0|0|0|0|0|0|0|0|0|0|0|0|0|0|0|0|0|0|0|0|0|0|0|1|
|1|0|0|0|0|0|0|0|0|0|0|0|0|0|0|0|0|0|0|0|0|0|0|0|0|0|0|0|0|0|0|0|0|0|0|0|0|0|0|1|
|1|0|0|0|0|0|0|0|0|0|0|0|0|0|0|0|0|0|0|0|0|0|0|0|0|0|0|0|0|0|0|0|0|0|0|0|0|0|0|1|
|1|0|0|0|0|0|0|0|0|0|0|0|0|0|0|0|0|0|0|0|0|0|0|0|0|0|0|0|0|0|0|0|0|0|0|0|0|0|0|1|
|1|0|0|0|0|0|0|0|0|0|0|0|0|0|0|0|5|0|0|0|0|0|0|0|0|0|0|0|0|0|0|0|0|0|0|0|0|0|0|1|
|1|0|0|0|0|0|0|0|0|0|0|0|0|0|0|0|6|5|0|0|0|0|0|0|0|0|0|0|0|0|0|0|0|0|0|0|0|0|0|1|
|1|0|0|0|0|0|0|0|0|0|0|0|0|0|0|0|0|6|5|0|0|0|0|0|0|0|0|0|0|0|0|0|0|0|0|0|0|0|0|1|
|1|0|0|0|0|0|0|0|0|0|0|0|0|0|0|0|0|0|6|5|0|0|0|0|0|0|0|0|0|0|0|0|0|0|0|0|0|0|0|1|
|1|0|0|0|0|0|0|0|0|0|0|0|0|0|0|0|0|0|0|0|0|0|0|0|0|0|0|0|0|0|0|0|0|0|0|0|0|0|0|1|
|1|0|0|0|0|0|0|0|0|0|0|0|0|0|0|0|0|0|0|0|0|0|0|0|0|0|0|0|0|0|0|0|0|0|0|0|0|0|0|1|
|1|0|0|0|0|0|0|0|0|0|0|0|0|0|0|0|0|0|0|0|0|4|7|0|0|0|0|0|0|0|0|0|0|0|0|0|0|0|0|1|
|1|0|0|0|0|0|0|0|0|0|0|0|0|0|0|0|0|0|0|0|4|7|0|0|0|0|0|0|0|0|0|0|0|0|0|0|0|0|0|1|
|1|0|0|0|0|0|0|0|0|0|0|0|0|0|0|0|0|0|0|4|7|0|0|0|0|0|0|0|0|0|0|0|0|0|0|0|0|0|0|1|
|1|0|0|0|0|0|0|0|0|0|0|0|0|0|0|0|0|0|4|7|0|0|0|0|0|0|0|0|0|0|0|0|0|0|0|0|0|0|0|1|
|1|0|0|0|0|0|0|0|0|0|0|0|0|0|0|5|0|0|0|0|0|0|0|0|0|0|0|0|0|0|0|0|0|0|0|0|0|0|0|1|
|1|0|0|0|0|0|0|0|0|0|0|0|0|0|0|6|5|0|0|0|0|0|0|0|0|0|0|0|0|0|0|0|0|0|0|0|0|0|0|1|
|1|0|0|0|0|0|0|0|0|0|0|0|0|0|0|0|6|5|0|0|0|0|0|0|0|0|0|0|0|0|0|0|0|0|0|0|0|0|0|1|
|1|0|0|0|0|0|0|0|0|0|0|0|0|0|0|0|0|6|5|0|0|0|0|0|0|0|0|0|0|0|0|0|0|0|0|0|0|0|0|1|
|1|0|0|0|0|0|0|0|0|0|0|0|0|0|0|0|0|0|6|5|0|0|0|0|0|0|0|0|0|0|0|0|0|0|0|0|0|0|0|1|
|1|1|1|1|1|1|1|1|1|1|1|1|1|1|1|1|1|1|1|1|1|1|1|1|1|1|1|1|1|1|1|1|1|1|1|1|1|1|1|1|
